$ANSIBLE_VAULT;1.1;AES256
35323031356561363265303230313238663031316238373237313036656261393265393831373563
3734356538386338353765343437333738653132353035370a343261643730356561363762366239
38623733633630613531333738326566303563333165636434666432613230656464376233316230
6133376334633063340a646130363061653562653834383864363338376635383736333633666262
62393865383235656437626137323333643765363365346166396461643135663132363231613166
38353436323434343766346563333037326165623136373438636462326539383464396235386461
32383463613533383633336235653338333863326264643138326532343462313537616135646435
39623536343830353164653234316332373161376638363266383737393634306537373235626163
66613562363536636262383163663934353832626636666433353163323665313737363732316665
38343233663066646338376433616339383536353566633362353430363764376132313966366635
61386330396339613036376133646436633262303763623566653164373230356439643965396134
66343334656437383436303334646533383463383963613834326466623136383238623464613530
64656366316561656330646435666334613232376261633163663339396366356366356336636439
32373062633331363436393937316465616336376430653232343864303766356134613530376363
33316164616632393764613663313863643835373232356335366632633031623061306466376166
32656363316638373431323232373830653461303862333531323838666162663464613237363661
30336638613130383736303863613162396638396262616566343565383438333865373265643330
64333133653639306661356232653862613732313037323838613231343465343133613937343239
37366462353361393432656434303962633238626631373461613933336163303039626165656332
66323561376134376235636338646331656665396564383162313033383564396236663036356264
33323365383135343037393664303261393439356338636666336332336165633539623335656334
34303737353837633766326166393836373863323935333434656239653133373135623434656363
38313634323534636363663363656166383461383661343036656337326638623735666435373039
38653132363638303562613132633438343864316238376165663231656534363339393862396537
61393234663136393936623337346336636133623731643964313264643030636133323965323838
61316535656331373433383764663532333762663031653939653662373530336238663963363134
32376139616661613439663531386639633139656236653438346532376234646364613430613134
36373637613036376433633137663637373939343937336333623963383539383433666462363961
39313563636266323263313031396631653538363263346439626434616236343866393734393664
37633839343937356362313036353939626131626338623735376535343136326538353365656164
36623931653662333537306236613761373830646564386465383331323030663466383562663961
39306233306465373063326166613664383036613163623336343964393833346139633466663135
65643061646665653134373232316163323738643931306438373866346137663939613130336262
32636435383336653336396238646136633234666234653139386338623130366533613038393638
32353830646361373036323963653131396464653231383732343931323262343731303631653336
61663631366261633862643335633033643132663462353234393363303464656130313530363866
34303130363536303937303962653561633761373239383030373466623132366130653266356163
37356266613365343666396162336163623033393563383035613164353131643634613863396638
36363531626139393638613635383561303466393732623033636565343461323736613434313331
37386463326436656538316133613639626666653863393931306638373636626234306566663837
36333634626663323330656137663234333234666438363463393539653362653364613637393162
39633430393366653164376338633966643365666162633332353965386365373738643165636165
39623737386537303763373835343061323033383563346365316365363136663265356239333334
34616638663739653537323834303738636366653331663739326362393239323130386463633666
63663861636631316665356262623334326334613161323937366631613138366438303633376532
61613566626165363163613962646239376364383538643233303865646466666666383265353833
32396237323264343939643861383635383662613839656363356330386230666338633263373635
38363232366562393465313166376230656637373538623234616638383130343661633464633233
34356564366136316530306535613536613564356335383137386238313339653835386430313538
64343739383337313162646636326230313437396364616461393264313738306138386166323636
64333762643234326339316533376262316463633364633734343037393432613538643631373931
66316130643264343736656262323563346364343366336165323830353935636132373665336161
34303330633861653431633236376430346262363238633063303737336335376462396332366333
65353962383164643034373565383330333633323634656665653562373936653161646636656637
63323330656530363235633836626434626661376330616261626532366362303666633866633230
30303361326163643734363033353966373463343937633364616634323930656266333864393864
37306339383864636162613265613961303162623930353762363731626238313634386537616436
34356363393764623762346361373837663136343933313762306335626661376530386339616239
34633733343264623463383763386363626231653934326264623664623736653532666439646533
65643531376164366632323139323237313163373334313363316138393736613963353135613762
36616630303635313564333037343435393034306439383838393965306339393338643463623033
36313561393433656532323232373035383835666330303339383065643531653133336237373332
61333963316237373365383931623532616364393064366533633163323336626362323734663037
66363966373733386433386138366564653465326462313935656232666438333438666161366466
64383466376332343937336537633361333765346336356565376139623631643632323335386361
31616363343831623232663264373233363337376363373461313332363838316434653636653639
34353663303136656466323263643930376264613336306636396461613631613237643733383838
63333065633632386165376638346238303830356636303338373830346565366465366162363465
62316133656633616135656538373439303736643430633963613664363336623866346364636464
32353739633235373663376139386637613634323039376531396539353639323831396465613638
31393132393963363131386662383265636530306163353937313131323031383732333866613432
64323035616430613734366366653239393362303633363361613461653339366135663966386130
37393631636363393435353061383433336264333639383233343661643431383530616263303832
39396439623235303939383962303037623933303430646631353466323633316566313431363232
38646538313539653066396234333030303433343466636534653030336637303263376535383462
63376539333430323532663861623861343333393232653566333337323830366132353663353535
65396635666131376232303537313530656337633239316163363330633261303938303031316131
31623866663538333531633635313763393964353437626137623863613066346564616333396362
61363664306333313362326537313966306330363131313734643135366630653634326162623935
66313461653461366132316432303334346438303137366262623232303163376630343465653365
30626138323663613039666466336137303430393739343063613835366162356663653139333035
64393339643362373261636331333035613764643534623434346263313632363362373435383039
31303030373837303332313635366365393937363963333735386366303635613530303536633762
37333037656463383832663432323534383937363462636339663865343937356630386362363534
34626565646537646230393935613331643533386362636433326265373336616265363334363232
61336335376431646661643035623764316534313164366432646364646638396337613864336539
36376366393661356531373364303337613138633736303766323030613366376331643433383139
61313165383962313764323261373932376265623563356431316536373035353931336639313536
65623561303861636164353965353666623735663133363031656362633434383162393738383762
38666130666236646137353730623538306333396531656238663965323363383636366335316363
61326635306435303731323235356434636230313238393334633463366532353736353232363630
62343933646365633230343162356634303431383861383263656335356638646631393437646432
30656535316530303736346635326639323962363832353532323464373035336437633630326663
64386238373430323132363836653064323032363132623333303365656237343235373064333235
65663138373031333163366436316432303136316537313363346133373161643764396131636630
64353762356439616137363936643666666234363564303230303033396664393433353763393363
38623766396131643562313138633134366532653861323935653637303265623562646530346231
34653039383665623465363962363632643931633337643838366463333734663162353635636230
37346138316430623437623763383731376534346236343333653264343362336564343535623462
62376562393735666165353533396664646332666161613861326530306262613662373963393163
64386436626530373737663337656331353565653565323137366436393633393636626538326131
31636638633936303531623565663962393233373338613266363166616132656363353436383638
65356162303361303436353766616535363834323539336131343435623435313930633063313830
35626336333763613164393938653433626465333766653734316366613065653065346432366634
61323762303866343233646538663933633539316630663430356436343836343961326436306335
66383261313839663266643430303435396437373534303232613436666430623264623930633837
34613539376133613137643236343139346335333338303462646430383038326339626565646130
63303763316530326235323264333337613832636136353265393265653337393466636138376638
34323038333736656135666638623832663833386466656535383865346236653036386665366462
35313565636339666130366364616335343838316434343532626265346435643461633535306266
61653362333238643533333332306132663435386462373634386533326335326632623665663563
66346138306139313134333639396537333663346131616335646662393036653962336632643764
30646230376332363138376134626339313964333730376139353133373039333964383266663233
62373232363235306335653730313838663230316439623264323035313162613762633866626134
61366130313236663933366339623361356633616331366166663562393234356363616563646333
63336362656464393634313936363134663032343030666537303964613737383539333933653736
33366433656463336632636139373561323065303461643063393030643566303461343438623538
38313264663737363536326565643538663734353432343530363035626334353330316139386162
65306463633862383333343166303433613039633733306236323037376539323966306638366565
34333937333562396466323237313035363362313431333937343162353966626662336535623733
33363833353864633533643431363962353539643963626362373338616463356662386362653734
39393064366638326361346164666638333465373737616237376639303963373039316566383631
61363961303161643936313934353061613931656233646665613536323131323265643063356563
31306665613262353833303634366637666437326562366331633665343163346131616438356337
39643165656431376338393665663831356561643930623734393036393966643432373235646666
32626363393364356632613336643036343533306333383163376565373431313735636639633234
38396638333165303162393538343761333133643031663965633936356431373764613036666464
64333665643930643835316664616236326563616430636139313235643333623532393731306564
33613934333531373037633864323965333765373137333130303365316366353266383637666562
64373937353261303765356136386233373264393638373562646135353837636530326230613231
30643963383838333231363162666131343031646437613734393362333537313835666537346238
30363133643330323466383662643163613230336535366630356439353436333634653761636339
34663733316530326638373263306564636666386339653235613865373263633939626532303430
39333435303165636538326266643233303933373565653130326137623037653730323165656330
34616266623332643337643139393266393963396232623637643038666437333337666164323435
31633939616637343466646263333430633531663931313661353737386336633665356634393535
31613565663731303164326466663630613633616137366531356531366466353233373765333964
63303262353861343237323338343936633964363232623634386464353236313434303637383764
66363866663363346366363934393464336537613063366630633266653832653665386439353334
30653830303464653635313938336531653138396335613036343233646136623230633631643265
32333431643730663635386564656230366433316363396433353236333061653466643535323966
39353331633661343231633337643436353438363132323239623761343162343234336263326639
36636363383832653961353466636361396162363631353334363535663737393063613365326135
63313830613632303539356564393539343535356237336338373765393736333937336430323865
33653832666366626233363463393761306237356230386630366539646238373165663063343164
33396262623861613264613839643563383134356535336361633865366464303261363731616137
66343734343234326462393164353235326430396539663064383538386536323061393761333436
39386430326234326132643161386461303538343961333162623566336561653131613130333563
62636464386639333265316432626662306534666566633365643534323262633362366530616331
35643463643965313032356433373239363035633936373465313835333237623633343237393835
37383365323530636633653964363532363566376336313733393631663333663662393334343934
35643433626466393965383735643339626437663637653265396137663438353134313436663366
36313335613537643137326532393730653635303264313732336437653333656435633239623463
62306463366261316132376530353931343962353962663930363762633031653938633835616466
39356264653631336438333864386237616338356439646531623964343831636233313733316163
38616435376633356430326365393466623962613837643532373933323165656638643262646630
39336462386134343839373838323230313931626436636238363339666630316337343933636134
39666631383265373831633265326634643235383264323932373637316366643565396365653565
32313530323734326630623263343264633264613865326235633063646564633233346364323366
66336534626237313462333765373466633430376264323534363766653664626437316464626334
38366666656334613361643637386266323236313430383665303862623963323264643838643033
33313861636138633337633338383233306261623631326634356333636462643461366161656365
33653434316462373339353864643637653463333331623435633265636361313431653436613063
31366539613038633831313039366432633036373539393338373665663139376564373337633964
62626566333563613330323431363633303036316536336433633531643737373130326565333437
62303861653666353761306337643133646130313836303563383665313736373036303135316466
33306437353038663631653631363632336564643733383665396430633930376337666139383835
36393231616535313536633131326231356132376563366264386630623530393736643533356135
62303262313530653131383963313737346533663765356239313839626436363761623835633263
62376130636462303639393362383165646138323030396139363063636236363961373065666433
39396531316337306536656266626363623233616337313736373338313933393363383131613137
31633964363931343033333866376131346638376363366630363239376230313736383033363832
34393230356333393531316431383362323333346235393230326461623239376166653833376461
61333466313231383662366138303831303737373334346331663438353666336539383334306238
66313062626534616333396161306635383061346166653131663931393232323935636563626165
65656161326363616365383864633761633139633264623139393762343332656530343637396466
34666665623834613162666636353961643236383332343230313561643939336432396632303333
31656137303464373465653739636562666637306532653033643538646435373130353538313761
37373132373565383862663832366437663165373362373065363539353439306333326531336637
39323463303465386638383037616162323733633962613561346437353065643232623439323537
62323739373931613435626534646235343531623033653838306663303838623532653036613234
37383330353937636335353939343536343464613939323161653065616165616565376435396236
33346365343838376431643865643662323234313162343265653535363961393635356133373565
30666539386137343762626634663730353137386463353930616339376365623639663931343365
63336431616664306465353930363861636433663634653533653539313338343533303765383236
36373133326435303132626534663062643732333631383433633732306561356364323963663732
62363337396466303630613464386363653238333531353632633830623535393638643832623661
61613161386631356333613031613533306132323766316634623331353833653530303032616234
63323362316230336563313831383934303430353934363532363631663937623038616535643336
39633464376532356634623032643837333830623565666662313530626465633836346566376333
66356233336338663639343239623361366638633231363432663330356635626461653430626631
34623132366366346336303466303963623437353363343533306466643364636632623261396436
66666138656363306537393830353963323662336538366463333834626635336236353766346532
39326238633161323931343163356439313533313266343235353537363766643131396439366637
32303763396335623366623932386631633062383433323765336530363866663735386234383133
34323630323534343065383432343639636132313065396233306263646666646238306565356239
62623439336466353938653236316334393638353639303630643338306338633966363634386463
32363533623161646336363030326333343537316562393139373437316237666232393138326632
64626532333834336630616464653562353039386266323738663434633234326366323931326462
39626438363265653732636236306363343731333338653866306433613965656630383230623833
36303335616134383538623662356635613237633265386164653833643634343862653964306466
61663362623635653364363938323837363630343161313261376236653831356330356131616430
37373530383262643464643833646533333262363662643936383539353438343037636365333339
33363263336532346236666337313133646166636633653565616665653131396635356336613034
66343237326235353264643038633638663031346130393837303733353661663634396461353633
34323931396337613366376334656665656436646265656161306234626131646364313866653730
39353831356566626539363933656666366232396163626465643034343530393561386134396135
30343963366465656637333164373932613465646230313532366264636138363364326630343334
66386530376666663038303731306462326266613434396631633065323462313833363836376639
39333135396264373731356661613830323936356630346333623930616434346165656165636262
64663937666236376462373139626165653265393865633237343036393536383364303330313562
35333864316237623737313839653263333734396132383231306564616565313235326135666463
31353737653237616263386335326561313430656238336664336435653930366538623633643364
38656238303863363435643337626361633965643536326264613966336563346236373738353333
37396138626562633132306465376432363430633665393135653930613065326462633338393865
33353130366532396236303963333163306534343161333765326465656162343261356538366633
61353361383761643061383432313731653266623662303063303438316465353331643861643462
63646630623139316463643837363761623332643463613366626135343132306334633334663266
39626437363332626435613530666164663538636466623037356664623230363264656666636164
66633733623039353135356564653137343366653563316136333736643135346439636538333365
39373832646436616234396432373431303062636665613933396639373038366533356631633763
35633037343766623466623934633765643763356339623434326137323134613665393935383564
37386130626363613330313639326561333337623666323331623865393938613433353137353634
34303338646635316262386164396233366165613933396265393036313336353038623866623961
61326133666132653333306330343435666265376537663538383633356232663335303663343366
37393737636134376530366138346165346139353034316663626561306536353032326263363362
38353632343465643064653332653061353538306438343833333535646635343765623130663834
61653535363830656233613933626634623933393662386233353239316637316464303063393331
30633062306566666435386539356637313632343862643764636365353866373433653562363665
34313130333335303736623231393539626636616537646162363661303130303736623364393639
61346230303462633135393031653335373066636666316330323631623863623765303738623633
66333332333430316537633735623132333732363939646165353336363033346236313734366231
32343863623061646661343435306364373138386234396239313436616335333435396265616265
31383837323436633035633030363266663366386439393838343533306237653934316164623239
64383362336264373738656331653434633763323162353738643630666665343563626239363863
36393265636362343533356433353264666335663161303462613931363566663239396333346434
66663661356138636539306337336238373261653066316638333132646431663562306430356334
36333239623238383533363761313035303639613861313636363633656564303736636431326234
65303838636334353231356464643065663138373631303838623932383135396635366639363661
32373763393232303862663837663839313539636331393133666633303835646535643936633766
36343632623230373435616264353661323435633763616332383937616435656334636462363939
30633038376337656364626261306363646362356234626438316131346365646236383135613364
35383130336532346663666663346431653262656161303163376638356237613132386432353537
34653762633032393533383864313663383664376563366232363866623565373464323865383963
35666463363630323130636138323566343933623762326461383865623731633761313765333737
65656663366332353837306665653363353333393534623632336337393538623730363430653365
30393039656666636663393235316665396566663832613734356431303065326463343031333934
32373665306465386366653937303665383137323366343062303139393763396532666666333236
38343038303338636363346565653137636661376464346465376230623766333465356564353539
33356534343437613962303837313932663831306531393564663832623434613862326633613939
32643962383431623461343937663163393737653235373433633931616437303839333332663038
38373438613864306362306637353063386634346339306666343632613035323932353739326266
63623364666363623839326462636637353961653930323362383863663235363430636539346634
31383163333364336632356262366134343761626139396534333066646163353835336230383664
39643139336230636139366361396133353637316665623036616364376432363639383537323935
66386336373563633162623064306535326461333864353632313837396364643938343534393638
3537
