$ANSIBLE_VAULT;1.1;AES256
66636266306137313532353962326438316435666632346566326532626339653638666265326236
3464326664366561303734396339656561323865303663620a636565393332323435303338356531
32376665633166623564333835316530323835656430346366666162633461663331633564663832
3838643132633839660a336339623234643233323461306564313634653364313435313136623462
30336237326534306333633032356461336132393266326339316436363666363234633936333639
39333235663664656363336136633430343635613735303738633130343038376461383064316538
36663130633235316534653033663338373537323238326439316235626635666438373661323439
37643062343733623136663638346665376533363834313062393438616439363364643633333731
38666538383033623937323965333032356435326138663763653839323138363032633639303737
32643234396430306333303262646563386134636366376637663461643238613530353939636537
35313339383738653439313639373461306235303837396537366133663834333132323364366463
32666431396563636663353532383936643038626131626166653939343237323532373932316538
64396538393766623466646632313132306363336361663764666564646332633834643039653032
35393832663964373534633630613735616533636561643430613831616631366462323737333330
64356230363737313632393161613364643763323262336238353364633061393236663264613835
65333537323964336437643664383065323034343936303262383739636565633936343130393337
38663839366338396266616637323265393333663132396132623264326261343664313832366665
33663232663061356234303331383932653231626166616435663537653764353033643866313966
36633336313839393365613964626365323564656234346633313330623333353939336437363837
35313664616237643632666262316666393962613131616330623034373334623538613862356434
38326166306130653735663334363436376234323832313832373634383236636665366130653431
35616665376433356135353265646562336361303663623330306230653731373836346333646465
61633034383232333837393435386436386662633331616366333165623131643838373736633633
34636362656363633036343939333036333136646238326233383536616535643939663638666363
30626335323336653939383739393430326239666438356134663139383363363939653034626466
65396266333734323335323837346563653737373635316632383264613362353033356666646463
66313136306336643236363637396266623936623561333232363562386138303438663639376431
33313863303339343265346165376637383566323662623664313862366338343435393931303864
39353030343262376538346638326235363365616335376636316335373862623862353731353965
39636166386333333336376137343965363465613465326634653436643235306538386564373564
64643834333562643537343436303562303864636630383736316163313737646339306537363062
63373435386438376532663662373832663539396265636664623538306231316266633865653934
36313963396339363964333636333366663331376134333933383766663437383730643732616663
32343630343462303038613732643136353337336664393837366365626136393333623833353666
30306331363062336530663038376664393336356364306536636431363633646262653637613066
34383538303634663230353039613737656634383938353831346164663032613235353261346161
30343539623463626437623239323066363166386236373032633034313534343364336138333666
61636433646264613965323939643132656633363039643165613339613032613538393133343731
65663464313234613936303533326263646139383163336435353562333964356333346465316137
31653336616262663038326635356535396338633536353564363635616532366261636166663031
34346566623265383432613134363061346136343464646633326264646262363930313739636162
38616465356464346337646431363836636265376335326636633236613534396438396266343666
33643462313663306164613034376238346632663861653963326232306237303362396638306335
66626563386664353761323563646166643862356161616132383263373835343165616637623861
34303062373663623539636538383735663666393538326336356161363864313562343730623133
66336433613736386136643534323761303362633363303565376430613936643332393762326331
363738383565643335366232363134383062
