$ANSIBLE_VAULT;1.1;AES256
61663638616235306432313236303661396661303063366265396261356534383537333535666136
3433623535386663643266663264613439333563663162340a353363303331376166643065376432
61313462393235613932373731303138353136333565396663356461396163326265373664303066
6363303632393866350a306339666164363136623130636463623236373461666434313034313834
64663866323436383763353764323862316536646234386465643335663262386363623161336238
31646439363665653538663639386266343434316130306139306238633432646662316636303736
33356534363562633430363532663537336262326161383635633839306661326662356436313036
32376436663663343637373836373266636536346638653034366633313339313865353837663231
65663061616639633933333063363634313138656239383436373362623463636234663936303635
66376336393865663162376635396564373166393535313733356333643437393264373736633333
66336334306263313163653966326230663435366334626631643866366131346334366538306431
31653030336639363837306264643862333434346435333231613861636537613362303030353639
35306564353230633264643433656261306461373831386237363062653232633033333833643361
31343831663637653664333738313732636436316565653237353432366239323662393130363938
62656537373832373966663734353663636431356461633730313636363437363463376331613262
61363731656166366633376264373061613932653061363762656161616465636435323630373035
34633534653833343537353765323738663264336634356562653863666130376434326232336433
31376166643733663966666262653438393263383263646534626230383135323334396332376562
32353763336562326662386162636538613132616336616531316639383330386532373333313734
66666463313966656463373963613862623831663939666662373238366237626234653230626137
38396363663437356131366635646436363336376238336232643261633362306431656138343361
39626338326465616263356361336532383234326633636336323039373164393531353638396531
32623332313330663961323763343564636233393262393737653231613036373933393936316633
33633861643366666133623261313363316431633739356564653939663764313935643931316632
63656362613436386166633661623239313236636632623331386666383330633032616334363166
36613338316331396632616666313434393436333862343831353266633634313935353939353237
65363437363262663564343930633262383837336465396130623633616334656234303266393436
62306434336466363834626533333364363663303436396530383333666364366435383962323331
61623237646165313165346238393461613864363737326666623963323965303539323135333130
64323236346535663936326136323338303130363239643537396134343531356430613363333239
38316162646562613634306435356465366433303964356535333338623764356536313330373930
61666434386333363662646166666665363732313264663931616438656462643132643264366639
63653963373039393935353264306230323433613939663766356663326463366633666334316139
39313162313738376666346637383666303133396564666636326235376637646231636236396563
64373239346364636435343161653036666366613834353132363534306161346537376335383965
63346131636432653638303433643661316361313033323338316430323339306232376631313838
36396466396565326134333633356566666564366462383133396532613863336336616161386565
62623538343562313533363135306435316163626564636539353932316133663565623262643334
31333566633931383166313466616535636664333963323033636433386536663135303039626339
62626634383936636162326431653836376239626361646436646462303439323630393337386531
39633465656639306538613231333338376630356437313931356564323764343038366435393232
32393061323737636331663736386135326461363737366261613037316366623232383731656339
36306233313239313733313230353061616634363663356534313863313664616362663735653431
61623030373337383633393731323730663665316266396236343430363931376664653336393934
61633237323166613937313037333063333131333638336130666634623634623762316666613731
37666233326530623630363739396231313035643163363366633936663464633836313832613236
653863616338643937656338303164396135
