$ANSIBLE_VAULT;1.1;AES256
30353962333332393462646561633066663431313339373634323536653065613364666365336566
3462633639393032303264613334343630663638303361640a643037656333383830343166346463
64666230666234323933333936323938626432313338646263323863636165623634323166343834
6630386362656335610a663665623430316632666138356365323330343836623939633635303537
34383362326237386230396564663562333561616435313366303861646564376430656430306664
33633136386161306235636336363765653666373163343433323065346136386533366237623031
36323166613563326635303235366133333233356636626230353964666135353861376333336431
34366438343364303965396237623966393964326636343135343638653732376234376132386333
63633261373839343333353763316337386630343432383431633836613236383239323231353963
61636439633365306636623639313663666366623264333237613037373634376634353038633233
38623162393061396464636633633032376363643539353365316432396466653333393037366564
64353761623163313931663235663931613864336139636263613865373836316664386638633632
38326361353939356231373236383463383034333563316437303337646130366631343832353430
61346136326365333638396336393136383632316661396234643833613632653631336134336633
63366539333335636265393962346335623061393863653532303861386336643661666239373166
36633764656664316437336332313361323663633436636164393733633637363833363363333630
39323739333634636130356165633537616261626264363830333836393135376262366337333336
32376632373739646137363263333361396532623537303432653639313836616133623634343431
38646238383536366166616366646265306166323635393034313966623863653335393362373635
36353231383837376330306462616535326662353736353762323939623634663730643231613638
61303166303263616237356630376339363736306362656632336662366364363339613635646265
64646632663831663466313262366435626339663166376366316666656533356565636161613965
35386165633861383366646636653861666238346334346237393862386461613837343165313431
64333437343466623063313862303463643962306630303737343234373366386534633331356165
65353137633431653737653938353333363133323365313830663266613735613866663234303663
30636531656261333733306536633662326637313763643361626464643333393963303638323031
35363632396365396433343663396465376338396164663265343733306532353232643462363062
34633661306339323133343365366366366164373836363930626233336162373831636465633537
33303431666439396332326332303765383539326662633361616466363366303961386636343131
35386539323931623965373934633062613663363236616666633161323337303166326562353236
61633731393939326437396166306261613865316132303939363134316363373136383836663333
33636363316361323235653737356232626230373835396232633937393834663635363130666635
35636537376565626666626466333761666434376334653333343939663132313732386431343837
32653839323139633439303463623364626136346134383732333162313462613033666233353066
33336632663232616231376339323163656635386663626330306336636330613863313331663538
61363035373136363063386664306362646662363461323335646238396230653730306561333131
61316630313731333430313531353639343030396264376130663130383661396430626665326239
38646333393164396133393463313464646338633366313664373732326230613436373338313930
38396665666664306563373265306465333430326366326663303661396137663561346434376239
32613136323938373438366366626635626235383134623136363638343731393362356661663336
30346437616161333565656133353361333630396665666630306234386262643761356164306232
35623061343666373261383630373932356133616566623661363965363661626461373665323133
65646265393736323130363837373939663033373638356238316161346530343662393931626263
33646664656662623235636264363833656165663739643037343431393936333466656535313130
31393466616565653966643865336538313637303465656134393561326364643236623364373531
37303464313266636265636666303732323163353033356436653035363939306261346530396539
333261656163376663373666316562313038
