$ANSIBLE_VAULT;1.1;AES256
39303830353834343238363530336330613263663964613630326237363435613961356337393633
6337313664616462313334303135346264356637623637340a336137383366323865663833633261
65373563623365663930366138346131303264353966646336626639653034343965393135343839
3238313236313830660a666138346631633332343437363563333364633066383565363038303135
62343233323739383539613865646630616365313531366638363331396532383865363932313736
34623465323663383038303464336438303932636331396261643830373738646438663539316665
39313333373635663436303861666530313032386230653931323465623835613362636538653834
64313130613962353962636262323362323262393632633633323462663466383432333233643261
62363634313164303966396334326639653132636235373334383931666332333936633832643731
35373035373465376334663064633063316466663466656365346132333338356439306163653434
64373536653131616534353738656437303862366336386263343833303565623962386266393839
30353131666135306436336339613263326566626661386263353563313634393065623131646431
36353639653830343062653137616563383130393836333430353933376463383163346331373036
37666331383234663231306330636561356139393039643839626563383862626464333235353365
64613061613031373439613930623432356635336330366464353139613162363637613232333264
30383036646265323462363265336337313635303064363936383064623533313065636466386664
31383161366339663662326538646166346237636232373963633164616431353830626263383965
30633239333663333865633838363039373237373066393466366166386236396535666563343839
31653138373933353133333136306132393062363162326139333730306338333863306632363030
36613231336539616261393235343761316431373564343066373362366233373664643839656465
61326262366461353032373230633634343433356233646332653166326430666139666261623638
37653237393235653364386263666136643634393734663836636562366134356631623931616561
31623638633431326364336432646437386538396439643564336234366165316239633036363562
65643738633238663435643139373366326339383034373439303164313936326331643466656565
32383763333231636433396436306338653236356565306534323964646434313236323263363637
33643565653032303537353564636163393564343663333463303938626531306530613533333534
38343938356239346362643133333434653634333838353364356539333431373863336334353634
63396339626164303662623436633265656131396266386666613338623239346230343930376266
34383339373936633931636133346332323634363437393331653838323635623936366538316664
33636635386461393836356338633333313236313939636435363736303235613839616166353266
36643961343137636236333762393932646361323031333632356531646665303065356631613365
63353736323032323366306165323735666564626662646263326235656563393662363638613338
31323435643830393838646162336135623962633661343339393662383231653364386538653933
38623139633739663430613466633032313533613435666566346538636565373931333834636666
30393832653764653938653435386266363137373039353333343663356439663937623862333130
31616538393930376365356137316363313066613330623231346163363066326266663334346435
61306333626661383166316562656331343539386133313836386338326135376434646139346361
30316565333562383861333637646532346436366639653937653530306166393832333866633162
35323731646331633864613139396464383636323132313262393030663361313864383536323834
34366132366264633631333162616433356331313834376532333165306433643235323462636261
61623165376137363334646330316438313835386466343237626664623838313630386230613963
35636264633631333431666337646434306534326539383537383363356364343362643837353732
66656165616561663965623935663233323930333833306361663335363363396530363531633630
36393331386134643839306165653532656336626162353066383537343631323638363266636434
63313036303365386332646266366265646430366538306332666631636134336362393266356532
37336661626435623365306233653833393562356232633431313464363530316164333637616265
39326431373737376265363233306164323739623037386366346465326430323966313536376231
62333865343766656433
