$ANSIBLE_VAULT;1.1;AES256
66363332623535623937666666393561643261336130303132656635333062323835366331393036
6264663836376237653239343538313564663462333737610a646137353930393165643731356462
63313030343737636630363432643361383537353732363162623430626635306338343231356565
6461626433626134310a643366626139333966343231333830396239326465313863346132613065
35616565323032303065663537613031363734653332396631323935343738666138373531306664
61383063373630616339633936303364353961316333633637656366353533383832643262393537
61323532343738613030663932376432396166366331343530306335366231653831363665393637
31336336663534626433623765316536643830613164313130643233663561336434383863616563
61643664656465373161313238613962363030346165363363373463313134323031373861373230
38663837616237653565303237383963336439653937616562646133613364343765386466393665
36386537313831363261623263393533383035323864336132333933653965373862336335323834
33616565396535626338643932306638333564383464623438323239356631623539313564623165
37386637353030643061616532343537306632303861393930306462383038376264303633373566
66363561646530316639646661376338363435396466336532303338653062346636636362363662
63646338616362316430616337343963336132313831353838643433326533326637653564376433
30613538343439663463363766613064373463323864613866626665376433633335333665393861
62613865333032333063393534346333346437356435386237373234363539646461333165306337
65393135613166343563323332323836376135626462616332643965303564366232613332663639
62643730633038353831623430653937613766653666383139363466636264323861303338663962
36376534386561626566343138316535376565666639316166323239393438636562643133316362
64656363666438343639353837623934623337626636643562393938613036376538306231646437
38613262313534326530653936336134656165313766383831353034396131373535643866646235
61666132663462633237633032313338396462353336393336303265346262376236623166623961
31616531313735306330626138623436623866363733613362356236393265323931336438616639
61366233326237636364366439306337323066666133626661383962376166373330386234336335
64313739643932326533303136623335643936303163353562653866613865373163363933356436
33303133643132623637313933356264306638366162393130396534666361633937613265326363
62633730346136326235376239633264613162356436366531343731316530333266646466376335
34663832663331653539636437653834383135353730633663633064353562613732383065663734
64383838336238366633326438363166363738613735323866366535356361343033623134666438
61393766353035376266656166646430303161346638653636643036346631623137393933646333
61636664646138333862386638636233646331373761613730316332373437313362613236616130
35393164343633626631363737643537643135643130666436303761323137646664393136356165
63333965326237636361393731326463313964376162373464343364393731613232393033393334
31383030373432313733383561656638623663666534376538306666333938326165376665353431
63313537343434303532353462636632303862616534656631396632633538316638353836363764
37333839313733393230623735623866376436366565316463383233663933303238313434373861
33373731633931643133303862356438623134323263383731633734653132343365383034653961
36336336313630336665353138656362303165383635653265353265336361623436393035316233
31633665393062386634383266663865343336643135393264633137383533323937633765663235
39663765323239353466633865663638666339666131363532303161336337323461353531336565
66333064333165383038393433303834323533336161623934333433646331656330393335383363
35626637616539633239396536373438333833336339643137653063346433336334613731386631
65316566353433663337376435653533336165343336343535336464656466653362373465316132
37663865396363393233613762663063343430626634303334313137346466643936653463306266
63336264653535656135623765336637343531313564656533663530643438353063376362363739
366336323362373238393732373539343635
