$ANSIBLE_VAULT;1.1;AES256
63653361626538373437366439616436323037626563643364393763396166633439373862383139
3163653637336462323333353761383239623130393332620a386464393464393436643161306634
62353734366538363232336235363232303539313361613863313361303035653730386633373333
6662376337623239620a633436386235313339623836333431336635356637633162396435616264
39613137373033613035323931386166636535306632353530623966326262656234343839336632
33333031363737366361353763396336366162373237613032343132396135653465393538626566
32316261303065323866393161666331653734613364396339366339366664363331343663316437
35663036303037396663393736633865323135643532393830346638383336616665313662383236
32663364626564326531646462386238623839373839653230383563363032376265373631646437
63323366646662663537663332373163323432386431663636376335363730613861396633616663
35326539363662333035396231613039333935363066613132343030373437313464646239646164
34396563636237333962643235646365613632313563636165613534613531613237373066356636
37666263666661383338346566306536626261383035643562303538323037613162376331343935
62303131353736613263663363663661343962383765303837636533643261613832666631333031
33666639316334336634306237303635306437386130636233623131373735623261303736663632
37396562306263333566366462636463396331393762303835616662393863353537666636303062
61323964666135663236316330393736346535643661393163613661623562336537346665356632
66326439636533646131313733363235343638386337613064623331396530313537643532633663
38653334366633353036613461663539633466393130383661633633623361323430346366643632
33336363313030666162643532653038643664303339646562633139663464343330303037316235
38353339333062613466313032393638313437356436303261366263386362346635326637623030
36653462343664653163346638366464643437363131383361373634373963303733313734333038
66303130393438343265303835643564633334333630663566363961326333373939303030326235
36333565393635616661656339666131653934623836663538663736353633393665333361643232
65616235386161643032663131346561383932356266636331626439343033393835383239353832
61353161666265643166333862346134313865366534323735613836613165633231633366363432
62343532353833633439643633363764366264623133303130646235336166383862306232313737
35386133343435656265383235643831636463303232343539646163353963373633653738373063
64346434373734356463633764396331386632643836653631623562393435333331383364393765
65616638363738303339613638303034376164666537366263383661393564653563303834356534
35303863383935626435623966643734373033613337636566343132313731393539653066643434
39663038613935396633376161333337356331623836396166396234303939643965383565653231
35373737383831346565633961636233643734396138353035653232373166356231333937386539
31373130333733313232646337636231656236363030393465386335356133656166323136663966
30306630346439383162633935353032303964353461643266633264396266626335373362303466
66356464383637313663653137393966333736646435346331393531366432323362623664373032
64323065323736626338643237353532653631313961356530616531316634393735636232626234
61333837656130336662616438393630373630376163643838646438663464653164663339353033
66636436326438363432643237323232653933396537636239323266343437303137316263663566
35653463613366613034363062353030313763333263303436663236393466663166616366323938
37643733633138616638326630326365653466663735633765653561613331623236316237633461
31316539636163623261666231613962383635623631333831613636613965346139303265353032
33393137333232343635636161373639336663363461396430653862356432306136623737353934
36303738653031653633346431386538613033623765303939373661633035376164646239326462
31396263653935656536316133303233373536636263343563643265653933656561613336326161
62386536386534383833366333373337613135666535336231313132643766663561363232366363
373433353830393662623739376462626532
