$ANSIBLE_VAULT;1.1;AES256
62323264323865326665616433343535313766613037663735613364663030323635343466643738
6533626339666531366663653236643461363638343963640a346535353661323964616636666531
39643135323331373033623633303632363465353031356239363834313366303134336337336265
6162643965326430350a656437643037366534656464653961306662653034323963346263393162
38303264386662316338383938623430363539626431336638303432343730333034333665333836
39643734633234386162306133383861346133376239336339646238386335653231386133376334
38393436613033656237386261396235303166646564616434633334616365306466653439376264
37386662656566326566366630663533646162616266383662663935316266666462323037626265
34373638666530343864666231336437383763353965663637613161356566306539323762376161
65643065303636633138616538336535326232333164363061316638376133326565326565656438
66313836353239313535663231396562316432373764663833333030393861323662393632633332
31313233613331363336356265363261356334356434376366306235613165326461323933393239
64643438643564316430643862393135613133336564666133343031333466316561356664633936
62663536313761666261646562343735356431353832616334623034366364356136656663663639
33326233333530653066303166333933336536303736366634626638316662373162316130366331
66626566653638626632376338303939326362663332646439613036306530633036356636643238
38336137613362623161656134636231336532326633666633336634653366333539653263313732
35663164633233656536336466656438396362313937393561613236306630326265303463336238
64373363366661346538623232663133663065396238626438393733333063646361333039656230
61323663636565376535323339663562333561363635656137623338353435646561353633633165
63646638386335366437623832623933633037633366366139333631663161656161353963386662
63353731333265313338366139333866663835363433623039353262383562353938383436326339
64613638633934373834383732346662623130363734386631333738303165363634303033666361
35376561653961646566323363303039623165613237376631616233646462633830326536353466
30646133633437316331396133313561656639363362366534396366623734383863323133393964
36383030326133336235653630363533313138633835393866303462616361386239373666333230
65373639653630303064326330346135386136333739393965346630616236333238636363636539
30623730303330303065626466666438333439363465343666353430303635663237323431396563
35623666363134313437373136396231653164383665313230353563383639396439646631383163
65343137636131643539343165666631623633363965663865386134623434343732313730663537
36636432623166326430666361353131343565313339626162336563326333306130333263343139
37613732373332346161323161653839613935336434656435346131623033343138303938613734
35386631636138306639306333306535313533646632343233316135653034613033626161656434
63313265313935316165666461356333313330633866303433373837353237343763393361343530
39626537326433363232346534336130363934373936343630663034643030626365353939363163
35363062386636393830366332386532363736623065313231613565643634643731643231623063
38656561343762356139356439653763326438636266366434376562636235343263333561383031
35306538616431653966393865656634306562623162386639323435346238336230666161343264
35386336373830636436383733663036353337666562373465336466636662646561326562383530
36626434616337393839303431306266326630373036346164346534303762353661343439663538
38383465626265663435376231313937646163346461383337303535646632393430363365336564
35326632623531373164313263346163313066646264396335633035316366313164663666346630
64303232666136396564333837313566636135356132333332313638383130643830613735363066
65313435383535373762663434633135343236386466613564626336633130656562366364323961
63653133343063636239373865336437343738623439346566343064623538356236353761366465
34623135356663353937313661356333313130646533663638653465643836626531353536663537
626436333464393433353937333339653064
